###########
#H...@...R#
#.#.##..@.#
#..@#..#..#
#@#.@.@...#
#..#...#..#
#..@..@.@.#
###########