#############
#H.........R#
#.#..#..@...#
#..@#..#....#
#...@.@..#..#
#..#...#....#
#.@...@.@#..#
#...#...@.#.#
#...@.....@.#
#############